5 10
|--------|
|.F.|..-.|
|..-|.@b.|
|.F....-.|
|--------|